
  SO	assets/south.xpm

     NO          assets/north.xpm    

 WE assets/west.xpm




 EA assets/east.xpm

   F     30  ,  30  ,  30      

         C	 240,155,34



1111111111111111
1B000000000GDLB1
1003333000222001
1000004000002001
1E0B0B4000002001
1003333000000001
1000000L00000001
10004000400000G1
1113131113003111
1111111113DD3111
1111111113003111
1131111113L03111
14G00000000000B1
3000000000000001
1000000000000001
1002000003404301
1L05000000303001
1002000000000001
1000000000000001
3000000000000001
14000000400400G1
1133003313313111
1113003111111111
13340G4333333331
3B0000000000B0L3
3000000000000003
3000000000000003
30050L050L050003
3000000000000003
30000000000B0003
3GB0000000000003
3333333333333333