
  SO	./assets/south.xpm

     NO          ./assets/north.xpm    

 WE ./assets/west.xpm




 EA ./assets/east.xpm

   F     30  ,  30  ,  30      

         C	 240,155,34



1111111111111111
100000000000D001
1003333000222001
1000004000002001
1E000B4000002001
1003333000000001
1000000000000001
1000400040000001
1113131113003111
1111111113DD3111
1111111113003111
1131111113003111
1400000000000001
3000000000000001
1000000000000001
1002000003404301
1005000000303001
1002000000000001
1000000000000001
3000000000000001
1400000040040001
1133003313313111
1113003111111111
1334004333333331
3000000000000003
3000000000000003
3000000000000003
3005000500050003
3000000000000003
3000000000000003
3000000000000003
3333333333333333