
  SO	./assets/south.xpm

     NO          ./assets/north.xpm    

 WE ./assets/west.xpm




 EA ./assets/east.xpm

   F     30  ,  30  ,  30      

         C	 240,155,34



1111111111111111111111111111111111111111111111111111111111
1000000000000000000000000000000000000000000000000000000001
1001111000111000000000000000000000000000000000000000000001
1000001000001000000000000000000000000000000000000000000001
1E00001000001000000000000000000000000000000000000000000001
1001111000000000000000000000000000000000000000000000000001
1000000000000000000000000000000000000000000000000000000001
1000100010000000000000000000000000000000000000000000000001
1111111111001000000000000000000000000000000000000000000111
1111111111000000000000000000000000000000000000000000001111
1111111111001000000000000000000000000000000000000000000111
1111111111000000000000000000000000000000000000000000001111
1100000000000000000000000000000000000000000000000000000001
1000000000000000000000000000000000000000000000000000000001
1111111111111111111111111111111111111111111100000001111111
1000000000000000000000000000000000000000000000000000000001
1000000000000000000000000000000000000000000000000000000001
1000000000000000000000000000000000000000000000000000000001
1001000100010000000000000000000000000000000000000000000001111111111111
1000000000000000000000000000000000000000000000000000000000000000000001
1000000000000000000000000000000000000000000000000000000000000000000001
1000000000000000000000000000000000000000000000000000000001111111111111
1111111111111111111111111111111111111111111111111111111111
