

1111111111111111  3333333
1B00L000000GDLB1 33GPCPG11
1004444000222001 3P00L0VP1
1000PG30000020V13300000VB33
1E0B0G3000002001B00222222233
100444400B0B20H1P000P5M00D011
1000000L333320M1B0030200020V1
1000400M4P0000G1M003000LB22011
1113131113003111333333P000200111
1111111113DD3111     33P00520001
1111111113003111      333P00V001
1131111113L03111        11100401
14B0DG00000000B1          1MB3D1
300444444300000111111111111111G1
1000000003000V01PGD0M0D000300003
1M020000034043010522222220333003 
1L05000000303M010K00000P5P0GD0M3 
10020000000000013333333033333333 
10V0000000000001      3L3  
3C0000V000000001      3G3  
14000000400400G1   3333D33333333
1133003313313111   3P00V0000M0P3
1113003111111111   3D225220V00L3
13340G4333333331   3G5B00004B3G3
3B0000400000B0L3   30200333304D3
3MK000D0000000L3   30000000003M3
3252222000000003   3000033333333
3PB5PL050L0500033333D3333       
3M00000000000000L00003         
3P0000V0000B0003333333
3GB00000PP00V0M3     
3333333333333333