

1111111111111111
1B000000000GDLB1
1004444000222001
10000G30000020V1
1E0B0G3000002001
100444400B0B20H1
1000000L333320M1
1000400M400000G1
1113131113003111
1111111113DD3111
1111111113003111
1131111113L03111
14B0DG00000000B1
3004444443000001
1000000003000V01
1M02000003404301
1L05000000303M01
1002000000000001
10V0000000000001
3C0000V000000001
14000000400400G1
1133003313313111
1113003111111111
13340G4333333331
3B0000000000B0L3
30000000000000L3
3000000000000003
30050L050L050003
3000000000000003
300000V0000B0003
3GB000000000V0M3
3333333333333333